11111111111
100000001E1
10000000101
10001000001
10001000001
100C1000001вафвыа
1000P000001
100C000C00100000000
11111111111авыфавыа